barcode	position
GTTAACGGATTATATCCAGATATTCCCAATTTCTTTTTTACCTTAAGT	Cassette1_1
TTTAACGGATTATATCCAGATATTCCCAATTTCTTTTTTACCTTAAGT	Cassette1_1
CGAGACGGATTATATCCAGATATTCCCAATTTCTTTTTTACCTTAAGT	Cassette1_2
CTAGACGGATTATATCCAGATATTCCCAATTTCTTTTTTACCTTAAGT	Cassette1_2
TTGGTCGGATTATATCCAGATATTCCCAATTTCTTTTTTACCTTAAGT	Cassette1_3
TTTGTCGGATTATATCCAGATATTCCCAATTTCTTTTTTACCTTAAGT	Cassette1_3
CATGTCGGATTATATCCAGATATTCCCAATTTCTTTTTTACCTTAAGT	Cassette1_4
CATTTCGGATTATATCCAGATATTCCCAATTTCTTTTTTACCTTAAGT	Cassette1_4
TTAAGTGGATTATATCCAGATATTCCCAATTTCTTTTTTACCTTAAGT	Cassette1_5
TTAATTGGATTATATCCAGATATTCCCAATTTCTTTTTTACCTTAAGT	Cassette1_5
TATGAGGGATTATATCCAGATATTCCCAATTTCTTTTTTACCTTAAGT	Cassette1_6
TATGATGGATTATATCCAGATATTCCCAATTTCTTTTTTACCTTAAGT	Cassette1_6
CTAATCGGATTATATCCAGATATTCCCAATTTCTTTTTTACCTTAAGT	Cassette1_7
CTAATCTGATTATATCCAGATATTCCCAATTTCTTTTTTACCTTAAGT	Cassette1_7
TATATTGGATTATATCCAGATATTCCCAATTTCTTTTTTACCTTAAGT	Cassette1_8
TATATTGTATTATATCCAGATATTCCCAATTTCTTTTTTACCTTAAGT	Cassette1_8
TAAAACGGGCCATATCCAGATATTCCCAATTTCTTTTTTACCTTAAGT	Cassette2_1
TAAAACGGTCCATATCCAGATATTCCCAATTTCTTTTTTACCTTAAGT	Cassette2_1
TAAAACGGTGTGTATCCAGATATTCCCAATTTCTTTTTTACCTTAAGT	Cassette2_2
TAAAACGGTTTGTATCCAGATATTCCCAATTTCTTTTTTACCTTAAGT	Cassette2_2
TAAAACGGTTGACATCCAGATATTCCCAATTTCTTTTTTACCTTAAGT	Cassette2_3
TAAAACGGTTTACATCCAGATATTCCCAATTTCTTTTTTACCTTAAGT	Cassette2_3
TAAAACGGACTGCATCCAGATATTCCCAATTTCTTTTTTACCTTAAGT	Cassette2_4
TAAAACGGACTTCATCCAGATATTCCCAATTTCTTTTTTACCTTAAGT	Cassette2_4
TAAAACGGATCGGATCCAGATATTCCCAATTTCTTTTTTACCTTAAGT	Cassette2_5
TAAAACGGATCGTATCCAGATATTCCCAATTTCTTTTTTACCTTAAGT	Cassette2_5
TAAAACGGTCCGCGTCCAGATATTCCCAATTTCTTTTTTACCTTAAGT	Cassette2_6
TAAAACGGTCCGCTTCCAGATATTCCCAATTTCTTTTTTACCTTAAGT	Cassette2_6
TAAAACGGTTCGTCGCCAGATATTCCCAATTTCTTTTTTACCTTAAGT	Cassette2_7
TAAAACGGTTCGTCTCCAGATATTCCCAATTTCTTTTTTACCTTAAGT	Cassette2_7
TAAAACGGTTTGCCTGCAGATATTCCCAATTTCTTTTTTACCTTAAGT	Cassette2_8
TAAAACGGTTTGCCTTCAGATATTCCCAATTTCTTTTTTACCTTAAGT	Cassette2_8
TAAAACGGATTATATCGGAATATTCCCAATTTCTTTTTTACCTTAAGT	Cassette3_1
TAAAACGGATTATATCTGAATATTCCCAATTTCTTTTTTACCTTAAGT	Cassette3_1
TAAAACGGATTATATCTGGCTATTCCCAATTTCTTTTTTACCTTAAGT	Cassette3_2
TAAAACGGATTATATCTTGCTATTCCCAATTTCTTTTTTACCTTAAGT	Cassette3_2
TAAAACGGATTATATCCGGCCATTCCCAATTTCTTTTTTACCTTAAGT	Cassette3_3
TAAAACGGATTATATCCGTCCATTCCCAATTTCTTTTTTACCTTAAGT	Cassette3_3
TAAAACGGATTATATCTAAGCATTCCCAATTTCTTTTTTACCTTAAGT	Cassette3_4
TAAAACGGATTATATCTAATCATTCCCAATTTCTTTTTTACCTTAAGT	Cassette3_4
TAAAACGGATTATATCCGGAGCTTCCCAATTTCTTTTTTACCTTAAGT	Cassette3_5
TAAAACGGATTATATCCGGATCTTCCCAATTTCTTTTTTACCTTAAGT	Cassette3_5
TAAAACGGATTATATCCAACTGTTCCCAATTTCTTTTTTACCTTAAGT	Cassette3_6
TAAAACGGATTATATCCAACTTTTCCCAATTTCTTTTTTACCTTAAGT	Cassette3_6
TAAAACGGATTATATCTGGACAGTCCCAATTTCTTTTTTACCTTAAGT	Cassette3_7
TAAAACGGATTATATCTGGACATTCCCAATTTCTTTTTTACCTTAAGT	Cassette3_7
TAAAACGGATTATATCCAAACCTGCCCAATTTCTTTTTTACCTTAAGT	Cassette3_8
TAAAACGGATTATATCCAAACCTTCCCAATTTCTTTTTTACCTTAAGT	Cassette3_8
TAAAACGGATTATATCCAGATATTGTAAATTTCTTTTTTACCTTAAGT	Cassette4_1
TAAAACGGATTATATCCAGATATTTTAAATTTCTTTTTTACCTTAAGT	Cassette4_1
TAAAACGGATTATATCCAGATATTTGCGATTTCTTTTTTACCTTAAGT	Cassette4_2
TAAAACGGATTATATCCAGATATTTTCGATTTCTTTTTTACCTTAAGT	Cassette4_2
TAAAACGGATTATATCCAGATATTTCGAGTTTCTTTTTTACCTTAAGT	Cassette4_3
TAAAACGGATTATATCCAGATATTTCTAGTTTCTTTTTTACCTTAAGT	Cassette4_3
TAAAACGGATTATATCCAGATATTCTCGGTTTCTTTTTTACCTTAAGT	Cassette4_4
TAAAACGGATTATATCCAGATATTCTCTGTTTCTTTTTTACCTTAAGT	Cassette4_4
TAAAACGGATTATATCCAGATATTCCAGGTTTCTTTTTTACCTTAAGT	Cassette4_5
TAAAACGGATTATATCCAGATATTCCAGTTTTCTTTTTTACCTTAAGT	Cassette4_5
TAAAACGGATTATATCCAGATATTTTAGGGTTCTTTTTTACCTTAAGT	Cassette4_6
TAAAACGGATTATATCCAGATATTTTAGGTTTCTTTTTTACCTTAAGT	Cassette4_6
TAAAACGGATTATATCCAGATATTTTCAACGTCTTTTTTACCTTAAGT	Cassette4_7
TAAAACGGATTATATCCAGATATTTTCAACTTCTTTTTTACCTTAAGT	Cassette4_7
TAAAACGGATTATATCCAGATATTTCCGGCTGCTTTTTTACCTTAAGT	Cassette4_8
TAAAACGGATTATATCCAGATATTTCCGGCTTCTTTTTTACCTTAAGT	Cassette4_8
TAAAACGGATTATATCCAGATATTCCCAATTTGCGTTTTACCTTAAGT	Cassette5_1
TAAAACGGATTATATCCAGATATTCCCAATTTTCGTTTTACCTTAAGT	Cassette5_1
TAAAACGGATTATATCCAGATATTCCCAATTTTGTCTTTACCTTAAGT	Cassette5_2
TAAAACGGATTATATCCAGATATTCCCAATTTTTTCTTTACCTTAAGT	Cassette5_2
TAAAACGGATTATATCCAGATATTCCCAATTTTTGTCTTACCTTAAGT	Cassette5_3
TAAAACGGATTATATCCAGATATTCCCAATTTTTTTCTTACCTTAAGT	Cassette5_3
TAAAACGGATTATATCCAGATATTCCCAATTTCCTGCTTACCTTAAGT	Cassette5_4
TAAAACGGATTATATCCAGATATTCCCAATTTCCTTCTTACCTTAAGT	Cassette5_4
TAAAACGGATTATATCCAGATATTCCCAATTTCTGCGTTACCTTAAGT	Cassette5_5
TAAAACGGATTATATCCAGATATTCCCAATTTCTGCTTTACCTTAAGT	Cassette5_5
TAAAACGGATTATATCCAGATATTCCCAATTTTCGCCGTACCTTAAGT	Cassette5_6
TAAAACGGATTATATCCAGATATTCCCAATTTTCGCCTTACCTTAAGT	Cassette5_6
TAAAACGGATTATATCCAGATATTCCCAATTTTCTTCAGACCTTAAGT	Cassette5_7
TAAAACGGATTATATCCAGATATTCCCAATTTTCTTCATACCTTAAGT	Cassette5_7
TAAAACGGATTATATCCAGATATTCCCAATTTTTTTTATGCCTTAAGT	Cassette5_8
TAAAACGGATTATATCCAGATATTCCCAATTTTTTTTATTCCTTAAGT	Cassette5_8
TAAAACGGATTATATCCAGATATTCCCAATTTCTTTTTTAGTCTAAGT	Cassette6_1
TAAAACGGATTATATCCAGATATTCCCAATTTCTTTTTTATTCTAAGT	Cassette6_1
TAAAACGGATTATATCCAGATATTCCCAATTTCTTTTTTATGTCAAGT	Cassette6_2
TAAAACGGATTATATCCAGATATTCCCAATTTCTTTTTTATTTCAAGT	Cassette6_2
TAAAACGGATTATATCCAGATATTCCCAATTTCTTTTTTATCGTCAGT	Cassette6_3
TAAAACGGATTATATCCAGATATTCCCAATTTCTTTTTTATCTTCAGT	Cassette6_3
TAAAACGGATTATATCCAGATATTCCCAATTTCTTTTTTACTTGCAGT	Cassette6_4
TAAAACGGATTATATCCAGATATTCCCAATTTCTTTTTTACTTTCAGT	Cassette6_4
TAAAACGGATTATATCCAGATATTCCCAATTTCTTTTTTACCCCGAGT	Cassette6_5
TAAAACGGATTATATCCAGATATTCCCAATTTCTTTTTTACCCCTAGT	Cassette6_5
TAAAACGGATTATATCCAGATATTCCCAATTTCTTTTTTATTCCCGGT	Cassette6_6
TAAAACGGATTATATCCAGATATTCCCAATTTCTTTTTTATTCCCTGT	Cassette6_6
TAAAACGGATTATATCCAGATATTCCCAATTTCTTTTTTATCCTAGGT	Cassette6_7
TAAAACGGATTATATCCAGATATTCCCAATTTCTTTTTTATCCTAGTT	Cassette6_7
TAAAACGGATTATATCCAGATATTCCCAATTTCTTTTTTATCTCCGGG	Cassette6_8
TAAAACGGATTATATCCAGATATTCCCAATTTCTTTTTTATCTCCGGT	Cassette6_8
TAAAACGGATTATATCCAGATATTCCCAATTTCTTTTTTACCTTAAGT	WT
